# Menu
User = Utente
Join... = Registrati...
Login... = Accedi...
Log in = Accedi
Logout = Esci
Change password... = Cambia password...
User Preference = Preferenze utente
System Settings... = Opzioni di sistema...
System Settings = Opzioni di sistema
Crash = Crash
Invite friends... = Invita amici...
Language = Lingua
Language Setting = Impostazioni lingua

Document Recovery = Recupero documenti
Your Preferences Information = Informazioni sulle preferenze utente
File = File
New = Nuovo
Project... = Progetto...
Schematic = Schema
Schematic-Simulation = Simulazione dello schema 
Spice Symbol = Simbolo Spice
Spice Subckt = Sottocircuito Spice
spicePre = 
PCB = PCB
Schematic Module = Modulo per Schema
PCB Module = Modulo per PCB
Save... = Salva...
Save As... = Salva come...
Save As Module... = Salva come Modulo...
Print = Stampa
Export Document = Esporta documento
LTspice... =  LTspice...
Eagle... = Eagle... 
Altium... = Altium... 
Cadence... = Cadence 
Pads... = Pads... 
DXF = DXF 
Import = Importa


Edit = Modifica
Undo = Annulla
Redo = Ripristina
Cut = Taglia
Copy = Copia
Paste = Incolla
Select = Seleziona
Delete = Cancella
Clear All = Pulisci tutto
Move = Muovi
Drag = Trascina
Bring to Front = Porta in Primo Piano
Send to Back = Porta sullo sfondo
Align = Allinea
Align Left = Allinea a sinistra
Align Right = Allinea a destra
Align Top = Allinea in alto
Align Bottom = Allinea in basso
Align Horizontal Centers = Allinea centri orizzontalmente
Align Vertical Centers = Allinea centri verticalmente
Distribute Horizontally = Distribuisci orizzontalmente
Distribute Vertically = Distribuisci verticalmente
Distribute Left Edges Equidistantly =  Distribuisci uniformemente lati sinistri 
Distribute Top Edges Equidistantly = Distribuisci uniformemente lati superiori
Align Grid = Allinea alla griglia
Rotate = Ruota
Rotate Left = Ruota a sinistra
Rotate Right = Ruota a destra
Flip Horizontal = Scambia in orizzontale
Flip Vertical = Scambia in verticale
Rotate and Flip = Ruota e capovolgi
Group/Ungroup Symbol... = Raggruppa/Separa simbolo...

[menu_project]
View = Visualizza
[/menu_project]
Find = Trova
Zoom In = Zoom avanti
Zoom Out = Zoom indietro
Fit in Window = Adatta a finestra
Refresh = Aggiorna
Snap = Allinea
Cross Cursor = Cursore a croce
Toolbars = Barre degli strumenti
Drawing Tools = Strumenti di disegno
Wiring Tools = Strumenti di cablaggio
Power Objects = Componenti di potenza
PCB Tools = Strumenti per PCB
Footprint Tools = Strumenti per Footprint
Layers Tool = Strumenti per livelli
Layer Manager = Gestione livelli
Enable and Show All Layers = Abilita e mostra tutti i livelli
Net Visible = Reti visibili
Auto = Auto
Digital Objects = Componenti digitali
Tools = Strumenti
Arc Center = Centro dell'arco
Arc Type = Tipo di arco
Center Point Arc = Punto Centrale dell'arco
Two-point Arc = Arco 2 punti

Place = Posiziona
Drawing Tools = Strumenti di disegno
Arc = Arco
Elliptical Arc = Arco ellittico
Ellipse = Ellisse
Circle = Cerchio
Pie = Torta
Line = Linea
Polyline = Polilinea
Rectangle = Rettangolo
Rectangular = Rettangolare
The rectangle does not support non-90 degree rotation. Please use Solid Region instead. = Il rettangolo non supporta la rotazione diversa da 90 gradi. Per questo puoi usare lo strumento Regione.

Rect = Rettangolo
Round Rectangle = Rettangolo arrotondato
Polygon = Poligono
Bezier = Curva Bezier
Path = Percorso
Graphic = Grafico
Bus = Bus
Bus Entry = Bus Entry 
Junction = Giunzione
Net Port = Porta di rete
Voltage Probe = Sonda di tensione
Power Port = Connettore di tensione
Wire = Filo
Annotation = Annotazione
Track = Pista
Image = Immagine
Arrow Head = Punta della freccia
Arrowhead = Punta della freccia
Arrow = Freccia
No Connect Flag = Non connesso
Place = Posiziona
Pin = Piedino
Lock Selected Objects = Blocca oggetti selezionati

Miscellaneous = Miscellanea
Find Component = Trova componente
Component = Componente
Footprint... = Footprint...
This component is deleted! = Questo componente è stato eliminato!
Convert = Converti
Convert Schematic to PCB = Converti diagramma in un PCB
The component ID will be reset according to the component prefix, this operation will clear Undo histories. Please notice: = L'ID del componente verrà reimpostato in base al prefisso del componente, questa operazione cancellerà le cronologie di annullamento. Si prega di notare:
Please make sure the component prefixes of the schematic and PCB are corresponding = Assicurati che i prefissi dei componenti dello schema e del PCB corrispondano
Please reset the component ID of corresponding schematic or corresponding PCB too = Reimpostare anche l'ID del componente dello schema corrispondente o del PCB corrispondente
Do you want to continue? = Vuoi continuare?
Reset Component ID = Reset ID componente
Component ID reset successfully! = ID componente resettato con successo! 
Convert to PCB = Converti in PCB
Update PCB = Aggiorna PCB
Shortcut Keys Setting = Configurazione Collegamenti da tastiera
Edit Symbol... = Modifica simbolo...
Highlight Net... = Evidenzia rete...
Simulate = Simula
Simulation = Simulazione
Standard Mode = Modalità standard
Simulation Mode = Modalità simulazione
Change to Standard Mode = Passa a modalità standard
Change to Simulation Mode = Passa a modalità simulazione
Welcome to Use LCEDA = Benvenuto in LCEDA
Welcome to Use EasyEDA = Benvenuto in EasyEDA
Enable Education Edition Features for Free >>> = Abilita gratuitamente la versione Education >>>
Quick Start = Avvio veloce
More Help = Ulteriore aiuto
Explore = Esplora
Message = Messaggio
[start]
Example = Esempio
Forum = Forum
Tutorials = Tutorial
Videos = Video
[/start]
Custom Data = Dati personalizzati
LCEDA = LCEDA

Copy Result Image = Copia immagine generata 
Export Result Image = Esporta immagine generata
Simulation Result = Risultato della simulazione
Simulation Results... = Risultati della simulazione...
Simulate this Sheet = Simula questo Foglio
Simulate this Project = Simula questo progetto
Non-simulation mode, please switch to the simulation mode first and then run = Non sei in modalità simulazione, prima passa alla modalità simulazione e poi eseguila
Run the Document = Esegui il documento
Run the Project... = Esegui il progetto...
Netlist for Document = Netlist per il documento
Netlist for Project = Netlist per il progetto
LTspice for This Sheet... = LTspice per questo foglio...
Spice for this Project... = Spice per questo progetto...
Protel/Altium for PCB... = Protel/Altium per PCB...
PADS for PCB... = PADS per PCB...
FreePCB for PCB... = FreePCB per PCB...
Eagle for PCB... = Eagle per PCB...
Kicad for PCB... = Kicad per PCB...
OrCAD for PCB... = OrCAD per PCB...
BOM report... = Genera BOM...
BOM for Document... = BOM per documento 
BOM for Project... = BOM per progetto
Pin Manager... = Gestisci piedini...
Spice Model... = Modello Spice...
Layer Manager... = Gestisci livelli...
Net Color... = Colore della rete...
Design Rule... = Regole di progettazione
Copper Area = Area di rame
Rebuild Selected = Rigenera selezionati
Rebuild All = Ricostruisci tutto
Copper Area Manager... = Gestisci aree di rame...
Export Pick and Place File = Esporta file per pick e place
Measure Distance = Misura distanza
Set Canvas Origin by Mouse Location = Imposta origine del foglio con il mouse
Generates Pick and Place File = Genera file per pick e place
Unroute All = Disfa tutto lo sbroglio
Auto Route = Sbroglio automatico
Export Autorouter File(DSN) = Esporta file Autorouter(DSN)
Import Autorouter Session File(SES) = Importa file di sessione Autorouter(SES)
Autorouter File(DSN) = File Autorouter(DSN)
Autorouter Session File(SES) = File di sessione Autorouter(SES)
Terminate Routing Automatically = Termina sbroglio automaticamente
Delete Segments = Cancella segmenti
Unroute Connections = Disfa sbroglio
Unroute Connection = Disfa sbroglio
Unroute Nets = Disfa reti
Select = Seleziona
Segments = Segmenti
Connection = Connessione
Net = Rete
Apply Design Rule While Routing and Auto Placing Via = Applica regole di Design durante il routing ed il posizionamento dei fori

Add SubPart = Aggiungi SubPart
Annotate... = Annota...
Config = Configura

Help = Aiuto
About = Informazioni
Shortcut Keys = Tasti di scelta rapida 
FAQ = FAQ
Tutorials = Tutorial
Basic Tutorials = Tutorial base
Video Tutorials = Video Tttorial
Essential Check = Controlli essenziali
Simulation Tutorials = Tutorial di simulazione
Updated Instructions = Istruzioni aggiornate
Open File Format = Apri formato file
About Upgrade = Informazioni sull'aggiornamento



User Forum = Forum per Utenti
Feature Request = Richiesta funzionalità
Feature Requests = Richieste funzionalità
Bug Report = Segnala bug
Bug Reports = Segnala bug
Tips & Skill = Suggerimenti e trucchi
Ask for Help = Chiedi aiuto 
Schematic Capture = Acquisizione dello schema
Spice Simulation = Simulazione di Spice
Non-simulation mode = Modalità di non simulazione
PCB Layout = Layout del PCB
General Discussion = Discussioni generali
More Information = Maggiori informazioni
Privacy Policy = Informativa sulla privacy
#Terms of Use & Privacy Policy
Terms of Service = Termini di servizio
Plans and Pricing = Piani e prezzi 
Help Translate = Aiuta nella traduzione
About Us = Chi siamo
Contact Us = Contattaci
Change History = Cronologia modifiche
Join Us = Iscriviti
#PCB Fabrication Capabilities
PCB Fabrication = Fabbricazione PCB
Order Capabilities = Opzioni ordine
Order Price = Prezzo ordine
Order Essential Check = Verifica di base ordine
Order FAQ = FAQ ordine
Order Process = Processo dell'ordine
Full Screen = Schermo intero

Support = Supporto
[leftNavTabs]
Support = Supporto
[/leftNavTabs]
Historical Records... = Dati storici
Extensions = Estensioni
Order PCB... = Ordina PCB...
Import Changes = Importa le modifiche
Press {0}F11{1} to switch to full screen. = Premi {0}F11{1} per passare a schermo intero.
Delete Selected = Cancella selezionati
Simulate... = Simula...
Config = Configura
Terms of Service & Privacy Policy = Termini di servizio & privacy
Help Topics = Aiuti
3D Model(obj) = Modello 3D(obj)
3D Model(step) = Modello 3D(step)
SVG Source... = Sorgente SVG...
File Source = File sorgente
Group These Items as a Symbol = Raggruppa elementi come un simbolo
Group These Items as a Footprint = Raggruppa elementi come un footprint
Set Canvas Origin = Imposta origine foglio
Document Setting = Impostazioni documento
Sheet Attributes = Attributi del foglio
Set Board Outline = Imposta contorno della scheda
Teardrop... = Teardrop...
Panelize... = Pannelizza...
Check Dimension = Controlla dimensioni
Smart Dimension = Dimensioni intelligenti
Footprint Wizard = Procedura guidata per Footprint
Footprint Wizard... = Procedura guidata per Footprint...
Select package type = Seleziona tipo di Package
Smart Dimension Attributes = Dimensioni attributi intelligenti
Global Delete = Cancella globale
Cross Probe = Cross Probe
Cross Probe and Place = Cross Probe e piazza
Paper Size = Dimensione foglio
Register = Registrati
User Center = Account

By Mouse Location = Per Posizione Mouse
Set Coordinate = Imposta coordinate
By Coordinates... = Per coordinate
By Center of Pads = Per centro dei Pad
By Center Grid of Symbols = Per centro della griglia di simboli

#Schematic Canvas Attributes
Properties = Proprietà
Attributes = Attributi
Apply = Applica
Save as default = Salva come default
Canvas Attributes = Attributi del foglio
Width = Larghezza
Height = Altezza
Background = Sfondo
Visible Grid = Griglia visibile
Grid Visible = Griglia visibile
Real-Time Track Length = Lunghezza pista in tempo reale
Display Real-Time Track Length = Mostra lunghezza pista in tempo reale
Grid Color = Colore griglia
Grid Size = Dimensione griglia
Grid Style = Stile griglia
Grid.Line Width = Larghezza linea
Grid.Line Spacing = Spaziatura tra linee
Copper to Board Outline = Da Copper Area a contorno scheda
Improve Fabrication = Migliora fabbricabilità
Spoke Width = Larghezza punta
Stroke Color = Colore tratto
Stroke Width = Spessore tratto
Stroke Style = Stile tratto
Fill Color = Colore di riempimento
Selected Objects = Oggetti selezionati
Frame Size = Dimensione cornice
Alt Snap = Allineamento Alt
Snap size when pressing the Alt key = Spaziatura allineamento quando premi Alt
Prefix Start = Inizio prefisso

#Text Attributes
Text Attributes = Attributi del testo
Text = Testo
Color = Colore
Font Family = Famiglia
Font Size = Dimensione
Font Weight = Spessore
Font Style = Stile
Text Type = Tipo testo
Text Anchor = Allineamento testo
Baseline = Linea di base
(Auto) = 
(auto) = 
start = inizio
middle = centrale
end = fine
inherit = eredita
comment = commento
spice = 
normal = normale
italic = corsivo
Default = Predefinito
Add = Aggiungi
bold = spesso
bolder = più spesso
lighter = più sottile
Failed to parse the font file: {name} = Errore durante il parsing del font: {name}
Please select a font file of ttf or woff format. = Seleziona un font in formato ttf or woff.
Add font success: {name} = Font aggiunto con successo: {name}
Failed to add font: {name} = Aggiunta del font fallita: {name}
Add Font = Aggiungi font
Failed to parse cached font: {name} = Elaborazione del font in cache fallita: {name} 
Load cached fonts fail! = Caricamento dei font in cache fallito!

#Stroke
Stroke Color = Colore del tratto
Stroke Width = Spessore del tratto
Stroke Style = Stile del tratto
Fill Color = Colori di riempimento
X Radius = Raggio X
Y Radius = Raggio Y

#spice
Switch mode = Cambia modalità
The current documents will be closed, and reopen after switching mode, do you want to continue? = Il documento corrente verrà chiuso, e sarà riaperto dopo aver cambiato modalità. Vuoi continuare?
PCB related documents are not allowed in emulation mode = I documenti PCB non sono consentiti in modalità emulazione
Please change the editor to "Simulation" mode first at the top left corner. = Prima devi cambiare l'editor in modalità "Simulazione" nell'angolo in alto a sinistra.
Please change the editor to "Standard" mode first at the top left corner. = Prima devi cambiare l'editor in modalità "Standard" nell'angolo in alto a sinistra.
Common = Comune
spice.open = 
spice.close = 
Sources = Sorgenti
Instrument = Strumenti
Transistors = Transistori
Digital Circuits = Circuiti digitali
Operational Amplifier = Amplificatori operazionali
multimeter = multimetro
multimeter Settings = Impostazioni multimetro
FunctionGenerator Settings = Impostazioni generatore di funzioni
Voltage Source Settings = Impostazioni generatore di tensione
Current Source Settings = Impostazioni generatore di corrente
Powersw Settings = Impostazioni Powersw
Resistor Settings = Impostazioni resistore
Capacitor Settings = Impostazioni condensatore
Diode Settings = Impostazioni diodo
voltPowersw Settings = Impostazioni voltPowersw
Inductor Settings = Impostazioni induttori
VCVS Settings = Impostazioni VCVS
CCCS Settings = Impostazioni CCCS
VCCS Settings = Impostazioni VCCS
CCVS Settings = Impostazioni CCVS
JFET Settings = Impostazioni JFET
FET Settings = Impostazioni FET
Transmission Line Settings = Impostazioni linea di trasmissione
Oscilloscope Settings = Impostazioni Oscilloscopio
XFMR Settings = Impostazioni XFMR
LOGIC Settings = Impostazioni LOGIC
LOGICSTATE Settings = Impostazioni LOGICSTATE
DIGITALCLOCK Settings = Impostazioni DIGITALCLOCK
Potentiometer Settings = Impostazioni potenziometri
MUTUAL_INDUCTORS Settings = Impostazioni MUTUAL_INDUCTORS
NE555 Settings = Impostazioni NE555
THREE_PHASE Settings = Impostazioni trifase
Logic_Probe Settings = Impostazioni sonda logica
78XX Settings = Impostazioni 78XX
79XX Settings = Impostazioni 79XX
OPAMP5PEE Settings = Impostazioni OPAMP5PEE
OPAMP5PEECN Settings = Impostazioni OPAMP5PEECN
OPAMP3PEE Settings = Impostazioni OPAMP3PEE
OPAMP3PEECN Settings = Impostazioni OPAMP3PEECN
DELAY_FUSE Settings = Impostazioni Fusibile ritardato
Ratio = Rapporto
K[%] =
Model = Modello
States = Stati
Voltage[V] = Voltaggio[V]
Voltage gain[V/V] = Guadagno tensione[V/V]
Current gain[A/A] = Guadagno corrente[A/A]
Transconductance[Mho] = Transconduttanza[Mho]
Transresistance[Ω] = Transresistenza[Ω]
Voltage Source Type = Tipo sorgente tensione
Current Source Type = Tipo sorgente corrente
multimeter type = tipo multimentro
power type = tipo potenza
Voltmeter Resistance(R)(Ω) = Resistenza volmetro(R)(Ω)
Amperometer Resistance(R)(Ω) = Resistenza amperometro(R)(Ω)
mu.V = mu.V
mu.A = mu.A
Sine Wave = Onda sinusoidale
Triangular Wave = Onda triangolare
Rectangular Wave = Onda rettangolare
AC = AC
DC = DC
SINE = SENO
PULSE = PULSE
EXP = EXP
SFFM = SFFM
PWL = PWL
B.spice = B.spice
DC Value[V] = Valore DC[V]
DC Value[A] = Valore DC[A]
DC offset[V] = DC offset[V]
DC offset[A] = DC offset[A]
Amplitude[V] = Ampiezza[V]
Amplitude[A] = Ampiezza[A]
Freq[Hz] = Frequenza[Hz]
Theta[1/s] = Theta[1/s]
Tdelay[s] = Tdelay[s]
Phi[deg] = Phi[deg]
Tperiod[s] = Tperiod[s]
Ton[s] = Ton[s]
Tfall[s] = Tfall[s]
Trise[s] = Trise[s]
Von[V] = Von[V]
Von[A] = Von[A]
Vinitial[V] = Vinitial[V]
Vinitial[A] = Vinitial[A]
Vpulsed[V] = Vpulsed[V]
Vpulsed[A] = Vpulsed[A]
Rise Delay[s] = 
Rise Tau[s] =
Fall Delay[s] =
Fall Tau[s] =
Carrier Freq[Hz] = Freq carrier[Hz]
Modulation Index = Indice di modulazione
Signal Freq[Hz] = Freq segnale[Hz]
Time[s]
Value[V]
Value[A]
Waveforms = Forme d'onda 
Duty cycle[%]
Amplitude[Vp]
Offset[V]
Rise/Fall Time[sec]
Capacitance[F]
sComponent = 
Inductance[H]
Gbw = 
Slewrate = 
Avol = 
Rout(Ω) = 
Rin(Ω) = 
Ibias[A]
Inhi[V]
Inlo[V]
Isc[A]
Outhi[V]
Outlo[V]
Vabsmax[V]
Vmin[V]
Iq[A]
Cin[F]
high = alto
low = basso
Oscilloscope = Oscilloscopio
Logic Analyzer = Analizzatore logico
Channel_A = Canale_A
Channel_B = Canale_B
Channel A = Canale A
Channel B = Canale B
Time = Tempo
Reverse = Inverti
Simulation file exceed = Il file di simulazione è troppo grande
The simulation file is too large and has been stopped for performance reasons. = Il file di simulazione é troppo grande ed è stato fermato per ragioni di performance.
Timebase = Tempo base
Scale: = Scala:
X pos.(Div): = X pos.(Div):
Y pos.(Div): = Y pos.(Div):
View meter... = Vedi misuratore...
The circuit has components without simulation model: = Il circuito ha componenti senza il modello di simulazione:
Your simulation interval is too short to simulate, please wait 5 seconds later and try again; if still show this message, may be you simulated over 500 times the maximum simulation times per day. = L'intervallo di simulazione è troppo breve, attendi 5 secondi e riprova; se ancora vedi questo messaggio, potresti aver superato il limite giornaliero di simulazioni.
Resistor1_US = Resistenza1_US
Resistor1_EU/IEC = Resistenza1_EU/IEC
Resistor1_3D = Resistenza1_3D
Capacitor1_US = Condensatore1_US
Capacitor1_EU/IEC = Condensatore1_EU/IEC
Capacitor1_3D = Condensatore1_3D
Rheostat_US = Reostato_US
Rheostat_EU/IEC = Reostato_EU/IEC
Rheostat_3D = Reostato_3D
Capacitor_Electrolytic_US = Condensatore_Elettrolitico_US
Capacitor_Electrolytic_EU/IEC = Condensatore_Elettrolitico_EU/IEC
Capacitor_Electrolytic_3D = Condensatore_Elettrolitico_3D
Inductor_US = Induttore_US
Inductor_EU/IEC = Induttore_EU/IEC
Inductor_3D = Induttore_3D
Resistor2_US = Resistenza2_3D
Resistor2_EU/IEC = Resistenza2_EU/IEC
Resistor2_3D = Resistenza2_3D
Multimeter = Multimetro
Multimeter_3D = Multimetro_3D
Oscilloscope = Oscilloscopio
Oscilloscope_3D = Oscilloscopio_3D
Signal_Generator = Generatore_Segnale
Signal Generator_3D = Generatore di segnale_3D
Wattmeter = Wattmetro
Wattmeter_3D = Wattmetro_3D
NSSWS1080T_3D = NSSWS1080T_3D
Voltage_Source_VDC = Generatore_Tensione_VDC
Voltage_Source_VSin = Generatore_Tensione_VSin
Voltage_Source_VPULSE = Generatore_Tensione_VPULSE
Voltage_Source_VEXP = Generatore_Tensione_VEXP
Voltage_Source_VSFFM = Generatore_Tensione_VSFFM
Voltage_Source_VPWL = Generatore_Tensione_VPWL
Voltage_Source_V_Behavioral_Source = Generatore_Tensione_V_Generatore_Comportamentale
Current_Source_IDC = Generatore_Corrente_IDC
Current_Source_ISin = Generatore_Corrente_ISin
Current_Source_IPULSE = Generatore_Corrente_IPULSE
Current_Source_IEXP = Generatore_Corrente_IEXP
Current_Source_ISFFM = Generatore_Corrente_ISFFM
Current_Source_IPWL = Generatore_Corrente_IPWL
Current_Source_I_Behavioral_Source = Generatore_Corrente_I_Generatore_Comportamentale
CCCS_1 = CCCS_1
CCCS_2 = CCCS_2
CCVS_1 = CCVS_1
CCVS_2 = CCVS_2
VCCS = VCCS
VCVS = VCVS
Three_Phase_Wye_Load = Carico_A_Stella_Trifase
Three_Phase_Delta_Load = Carico_Delta_Trifase
78XX = 78XX
79XX = 79XX
555 = 555
555_3D = 555_3D
Transformer_US = Trasformatore_US
Transformer_EU/IEC = Trasformatore_EU/IEC
Transformer_Center_Tapped_US = 
Transformer_Center_Tapped_EU/IEC = 
Mutual_Inductor_US = 
Mutual_Inductor_EU/IEC = 
Mutual_Inductor2_US = 
Mutual_Inductor2_EU/IEC = 
OR2EE_US = 
OR3EE_US = 
OR4EE_US = 
OR2EE_CN = 
OR3EE_CN = 
OR4EE_CN = 
NOR2EE_US = 
NOR3EE_US = 
NOR4EE_US = 
NOR2EE_CN = 
NOR3EE_CN = 
NOR4EE_CN = 
AND2EE_US = 
AND3EE_US = 
AND4EE_US = 
AND2EE_CN = 
AND3EE_CN = 
AND4EE_CN = 
NAND2EE_US = 
NAND3EE_US = 
NAND4EE_US = 
NAND2EE_CN = 
NAND3EE_CN = 
NAND4EE_CN = 
XOR2EE_US = 
XOR2EE_CN = 
XNOR2EE_US = 
XNOR2EE_CN = 
Digital_Clock_1Hz = 
Logicstate_0 = 
Logicstate_1 = 
Logic_Probe = 
Buffee = 
INVEE_US = 
INVEE_CN = 
Schmittbuffee = 
LM358N_US = 
LM358N_CN = 
OPAMP3PEE_US = 
OPAMP3PEE_CN = 
OPAMP5PEE_US = 
OPAMP5PEE_CN = 
Voltage_Controlled_Switch = 
Current_Controlled_Switch = 
FUSE = 
Delay_Fuse = 
Transmission_Line = 
Crystal = 
DFFEE = 
TFFEE = 
JKFFEE = 
SRFFEE = 
SRLATCHEE = 
SRNANDFFEE = 
SRNORFFEE = 
INVTSEE = 
INVODEE = 
Schmittbuffee = 
Cbuffer = 
SPDT_Open = 
SPDT_Close = 
SPST_Close = 
SPST_Open = 
Fast_Crystal = 
Lamp = Lampadina
BCD_Segment = 
Seven_Segment = 
Traffic_Light = 
Lamp Settings = Impostazioni Lampadina
Power[W] = Potenza[W]
Dropout Voltage[V] = Caduta Tensione[V]
Current[A] = Corrente[A]
Threshold[V] = Soglia[V]
Clock Rate = Frequenza Clock
TrafficLight Settings = Impostazioni Semaforo
BCDSegment Settings = Impostazioni BCDSegmenti
SevenSegment Settings = Impostazioni SetteSegmenti
SPDT Settings = Impostazioni SPDT
SPST Settings = Impostazioni SPST
LogicAnalyzer Settings = Impostazioni AnalizzatoreLogico
Fuse Settings = Impostazioni Fusibile
Wattmeter Settings = Impostazioni Misuratore Potenza
open = apri
close = chiudi
Common Anode = Anodo Comune
Common Cathode = Catodo Comune
AC Amplitude = Ampiezza AC
AC Phase = Fase AC
There are some parts haven't spice model, please use "EElib" and "Spice Symol" at "Libraries" of "Simulation" mode, or you can assign the spice model for them: = Alcune parti non hanno un modello associato, usa "EELib" e "Simbolo Spice" in "Librerie" in modalità Simulazione, oppure puoi assegnare un modello spice manualmente:

#Pin
Pin Attributes = Attributi dei piedini
Orientation = Orientazione
Line 45° = Linea 45°
Line 90° = Linea 90°
Arc 45° = Arco 45°
Arc 90° = Arco 90°
Free Angle = Angolo libero
Start X = Inizio X
Start Y = Inizio Y
Length = Lunghezza
Name = Nome
name = nome
Number = Numero
Spice Pin Order = 
Display Number =
Clock = 
Show = Mostra
Electric = Elettrico

#Junction
Junction Attributes = Attributi Giunzione
X Location = Posizione X
Y Location = Posizione Y
Size = Dimensione
Color = Colore

#Net Label
Net Label = 

#Part
Prefix = Prefisso

#Image Attributes and Dialog
Add Image = Aggiungi Immagine
Image Attributes = Attributi Immagine
Image URL = URL dell'immagine
Input an image URL = Inserisci Indirizzo URL dell'Immagine
Invalid image URL = Indirizzo URL Immagine non valido
Invalid Prefix = Prefisso non valido
Failed to load the image = Problema nel caricamento dell'immagine
Image URL contains special characters = L'indirizzo URL dell'immagine contiene caratteri speciali
From Web URL = Da indirizzo Web
From Local Computer = Da Computer Locale
Please select a png/gif/jpg file. = Per favore seleziona un file png/gif/jpg.
Please select an image file. = Per favore seleziona un file immagine. 
Select an image file = Seleziona un file con un immagine
Insert Image to PCB = 
Tolerance = Tolleranza
tolerance = tolleranza
capacitance = capacità
frequency = frequenza
Rated Voltage = Voltaggio nominale
Rated Current = Corrente nominale
resistance = resistenza
Resistance = Resistenza
Resistance[Ω] = Resistenza[Ω]
inductance = induttanza
Operating Temperature = Temperatura Operativa
Shape Invert = 
Image Size = Dimensione immagine
Color Tolerance = Tolleranza colore
Simplify Level = 
Corner Threshold = 

#PCB Canvas Attributes
Units = Unità 
Snap Size =  
Other = 
Routing Width = 
[router]
Routing Width = 
[/router]
Please using hotkey {0}{shiftw}{1} or {2}{tab}{3} to change track width while on routing. = 
Routing Angle = 
Routing Conflict = 
Remove Loop = 
Cut SilkScreen = 
Grid = Griglia
Grid 90 = Griglia 90
Grid 45 = Griglia 45
Copper Zone = 
Visible = Visibile
Invisible = invisibile
Ignore = Ignora
Block = Blocca
RoundTrack = 

#Track
Track Properties = Attributi Pista 
Layer = Layer 
Net = Net 
Start X = Inizio X
Start Y = Inizio Y
End X = Fine X
End Y = Fine Y
ID = ID

#Pad Properties
Pad Properties = Attributi Pad
Shape = Forma 
Hole(D) = Foro(D) 
Center X = Centro X 
Center Y = Centro Y 
Round = Rotondo 
Oval = Ovale 
Hole Shape = Forma Foro 
Slot = Slot
Hole(Length) = Foro(Larghezza) 
Plated = Metallizzato 
None = 
Paste Mask Expansion = 
Solder Mask Expansion = 

#Via Properties
Via Properties = Attributi Via 
Diameter = Diametro
Drill Diameter = Diametro Foro

#Hole Properties
Hole Properties = Attributi Foro


#TEXT
Text Properties = Proprietà del testo
Line Width = 
Rotation = Rotazione
Fonts Management = 

#Dimension Attributes
Dimension Attributes = Proprietà delle dimensioni

#Footprint Attributes
Component Attributes = Proprietà Componente 
Display Prefix = Mostra Prefisso 
Pin Name = 
Pin Number = 
Spice Pin Number = 
Graphics = 
Pattern = 

#Arc Properties
Arc Properties = Proprietà dell'arco
Start Angle = 
End Angle = 
Rotation Direction = 

#Rect Properties
Rect Properties = Proprietà del rettangolo
Round radius = Raggio del raccordo

#Circle Properties
Circle Properties = Proprietà del cerchio
Radius = Raggio

#CopperArea Properties
CopperArea Properties = 
Clearance = 
Pad Connection = 
Direct = 
Spoke = 
Keep Island = 
Fill Style = 
CopperArea conflict: copper area outlines in same layer with different net names must not overlap = 
Copper area rebuild complete! You can set "Copper Zone" as "Visible" at the right-hand property panel after single click the empty area. = 
Please create board outline first. = 
Board outlines are not closed. = 
Rebuild CopperArea = 
Edit Points = 
Direct = 
Spoke = 
No Solid = 
Board Cutout = 
Solid = 
[copperArea]
None = 
[/copperArea]

#Custom Attributes
Custom Attributes = Attributi personalizzati
Fixed Attributes = 
Add new parameter = Aggiungi nuovo parametro
Add New Parameter = Aggiungi nuovo Parametro
Add New Supplier = 
Mounted = 
Unknown = 

Custom = 
Scan the QR code below and open it on the mobile side = 
How to create a single layer PCB = 
Currently doesn't support layout single layer directly, please refer at: = 

#Dialog Register
Create an account = Crea un account
Username = Nome Utente
Password = 
Confirm Password = Confemra Password
Email = 
Please read this before you register = Leggete questo prima di effettuare la registrazione
Hi {username} = Ciao {username}

#Dialog lostPassword
Lost Password... = Password persa...
Find the password using your email = Ottenete la vostra password utilizzando la vostra email



#Dialog Login
Login = Accesso
Username or Email = Nome Utente o Email
Remember Me = Ricordami
Third party = 
Login and Register = Login e Registrarsi
Your login information seems expired, please login again. Don't need to close the opening files, you can continue to save them after login. = Le informazioni di login sembrano scadute, per favore esegui nuovamente l'accesso. Non hai bisogno di chiudere i file aperti, puoi continuare a salvarli dopo l'accesso.

#Dialog Reset Password
Reset a password using your email = Reimporta la password usando la tua email
Your registered email = Email registrata

#Dialog Reaction
Re-send an activation code to your email = Invia nuovamente il codice di attivazione alla tua email

#Dialog Invite
Invite friends to register = Invita amici per la registrazione
Your friend's email = L'email del tuo amico

#Dialog Add A New Parameter
Add a new parameter = Aggiungi un nuovo parametro
Key = 
Value.new_para = 
In BOM = 
Add into BOM = 
Invalid key = 
This field is required. = 

#Dialog Change Your Password
Change your password = Cambia la tua password
Old password = Vecchia password
New Password = Nuova password
Confirm Password = Conferma password

#Dialog Create New Design
Save as a New Project = Salva come Nuovo Progetto
Save as a schematic = Salva come schema
Save as Symbol = 
Save as a spice Symbol = 
Save as a spice subckt = 
YOU MUST CREATE A SPICE SYMBOL WITH EXACTLY THE SAME NAME AS THIS SUBCKT = 
Save as a PCB file = Salva come file PCB
Save as Footprint = 
Save as a Schematic Module = 
Save as a PCB Module = 
Save as 3D Model = 
Save as a WaveForm = 
Title = 
Share = 
Add file = 
Visibility = 
Allow Comments = 
Public (Anyone can see this project but only you can modify it.) = Pubblico (Solo tu potrai modificare questo progetto. Tutti potranno vederlo)
Private (Only you can see and modify this project) = Privato (Solo tu potrai vedere e modificare questo progetto)
Create new project success! = 
You can now create files under this project = 
This file must be saved under a project, choose other project or create a new project = 
Please login to save this kind of document = 
Duplicated project title = 
#Duplicated document title
Project does not exist = 
Document does not exist = 
document not exists = 

Categories = Categorie
Project = Progetto
Short description = Breve descrizione
Content = Contenuto
Modify this project info. = Modifica le informazioni di questo progetto.
Modify this file info. = Modifica le informazioni di questo file.
Notice = Nota
Search for it before creating a new one. = Trovalo prima di crearlo.
Manufacturer Part Number = 
Supplier = 
Or = 
Supplier Part = 
Supplier Part Number = 
Link = 
link = 
The professional function please refer at: = 

#Dialog Clone My Part
#Clone it to a project
#Clone it, then edit it
Clone your file = 

#Dialog Subckt
Attach a Subckt to this spice symbol = 
Subckt string = 
Spice symbol title just allow [0-9][a-z][A-Z] and _

#Design Manager
Design Manager = 
Nets = 
DRC Errors = Errori DRC
Are you sure you want to unroute this net? = 
Unroute = 
Track Length = Lunghezza Pista 
Via/Hole Outer Size = 
Filter nets = 
Design Rule Checking = 
Board Outline = 
Plane Zone = 
[drcRule]
Width = Larghezza
DRC Width = 
Length = Lunghezza
DRC Length = 
Drill Diameter = 
DRC Drill Diameter = 
Diameter = Diametro
DRC Diameter = 
Object = 
DRC Clearance = 
[/drcRule]
#It will take a while to unroute this net, do you want to continue?
More than one netlabel is found in wire, please checked whether this is correct, if you design it on purpose, please ignore this warning. = 
Incomplete net, a complete net should contain two or more pins, if you design it on purpose, please ignore this warning. = 
This netlabel is not connected with any pin. = 
Incomplete connection, please check. = 
The clearance between two objects is less than the Design Rule Checking (DRC) clearance which has different nets. = 
The diameter is less than Design Rule Checking (DRC) diameter = 
The drill diameter is less than Design Rule Checking (DRC) drill diameter = 
The track length is longer than Design Rule Checking (DRC) track length = 
The track width is less than Design Rule Checking (DRC) track width = 

#Dialog Simulation
Show your simulation report = 
Download netlist = 
Run = Avvia
Components = Componenti

#Dialog Import
Import file from your computer = Importa file dal computer
Maximum file size: 30 MB = 
Maximum file size: 100 MB = 
Chose file = Scegli file
File Operation = 
Import File = Importa file
Extract Libs = Estrai librerie
Import File and Extract Libs = 
File type = Tipo di file
The file size is too large. = 
Please selected the file type. = 
No component was found! = 
Import successfully = 
Import failed = 
Click OK to continue with the import = 
Select None = 

#Dialog Modify Symbol Information
Modify symbol information = 
Spice Prefix = 
Hide Pin = 
Pin Manager = 
When a power pin is hidden, it will be marked as netlabel, you don't need to wire it. If you use it as simulation, please show it or create a GND/VCC Net for it. = 
Assign = 
Supplier.bom = 
LCSC.bom = 
Price = 
Quantity.bom = 
Package.bom = 
Components.bom = 
Manufacturer Part.bom = 
Manufacturer.bom = 

One-click Purchasing at LCSC = 
Order Parts/Check Stock = 
Export BOM = Esporta BOM
Export PCB BOM = Esporta BOM PCB
Export Schematic BOM = Esporta BOM Schema
ID.bom = 
Name.bom = 
[bom]
Name = Nome
LCSC Assembly = 
Value = Valore
ID = ID
Supplier = 
LCSC = 
Price = 
Quantity = 
Package = 
Components = Componenti
Manufacturer = 
[/bom]
Manufacturer Part = 

#Dialog Run
Run your simulation = Esegui la tua simulazione
Transient = 
Maximum Timestep = 
Stop Time = 
Start Time = 

AC Analysis = 
Type of Sweep = 
Number of points = 
Start Frequency = 
Stop Frequency = 

DC sweep = 
Source to Sweep = 
Start Value = 
Stop Value = 
Increment = 
DC Transfer = 
Output = 
Source = 

DC op pnt = 
Compute the DC operating point treating capacitances as opens and inductances as shorts = 

#Dialog Share Info
Active File = 
Active Project = 







Readonly = Sola lettura
Editable = Modificabile
Active file's owner project page = 
Active project editor page = 


#Dialog Document Recovery
All Projects = Tutti i progetti
Document Recovery = Recupero documenti
Unsaved files = File non salvati
Please select a file! = Seleziona un file!
Please expand the folder first, then select a document to recover. = Per favore espandi dapprima la cartella, poi scegli il documento da ripristinare.
Are you sure you want to remove this backup? = Sei sicuro di voler eliminare questo backup?

#Dialog Find Libs
Search = 
Search Results = 
Search and press Enter = Cerca e premi Invio
Keywords at least 3 characters = 
Assembled = 
Verified = 
In stock = 
{page} of {pagecount} pages = 
Common Modules = 
User Contributions = 
More = 
Add Favorite = 
Remove Favorite = 
Add Sub Part = 
Untagged = 
Package = 
package = 
Title(PartNO) = 
No Data! = 
Quantity = 
Manufacturer Part = 
manufacturer Part = 
Manufacturer = 
manufacturer = 
voltage = 
Library = 
LCSC Assembled = 
JLCPCB Assembled = 
User Contributed = 
Symbol = 
Follow = 
Types = 
Classes = 
power = 
Power = 
LCSC Part# = 
Stock = 
Report Error... = 
Report Error = 
Thanks for your feedback! = 
Report error success, thanks for your report! = 
The content must be at least 2 characters! = 
This library is user contributed, please check before using. = 
[lib]
All = 
System = 
Personal = 
Created = 
Favorite = 
No Team found. Please join or create a team first. = 
Create a team = 
No follow user found. Please follow your friend first. = 
[/lib]


BUY = 
In Stock = 
Out of Stock = 
Minimum = 
Distributor = 

Capacitance = 
Frequency Tolerance = 
Power (Watts) = 
Power - Max = 
Frequency = 
Voltage Rating(Vdc,Vac) = 
Voltage = 
Current Rating = 
Rated current = 
Resistance (Ohms) = 
Resistance(Ohms) = 
Inductance = 
FET Type = 
Current Rating(Max) = 
Impedance @ Frequency = 
Voltage - Input (Max) = 
Voltage - Input (Min) = 
Voltage - Supply = 
Voltage - Max = 
Current - Output = 

#Dialog Export Your Works
Export your works = Esporta i tuoi lavori
Export to = 
Zoom = 
Image Type = 
Qualify = 
0 means real size = 
Merged layer = 
Separated layer = 
Paged layer = 
Layer = 
Export = Esporta
Mirror = 
TopLayer = 
BottomLayer = 
TopSilkLayer = 
Protractor Attributes = 
BottomSilkLayer = 

BoardOutLine = 
TopAssembly = 
BottomAssembly = 
Mechanical = 
DocumentLayer = 
Inner{number} = 
Substrate{number} = 
Color = Colore
Full Color = 
Canvas Setting = 
Full Graphics = 
Assembly Drawings = 
Object Outlines = 
Invalid file format = 
Failed to export file = 
Download now = 
Wire Width = 
Sheet = 
Merged sheet = 
Separated sheet = 
Engine = 
Exporting PDF = 
Export 3D Model = 
[exportDocument]
Size = Dimensione
[/exportDocument]

#Dialog Import Changes
Confirm Importing changes information =  
You can't undo this operation, Please run a Design Rule Checking (DRC) after this operation. = 
Apply Changes = Applica le modifiche
This is a simple Design Rule Checking (DRC). = 
It just can help you to find the obvious errors = Ti può aiutare per trovare gli errori ovvi
There are some unfinished nets, do you want to check the nets first? = 
Yes, Check Nets = Sì, Verifica Reti 
No, Keep Going = No, Continua 

#Dialog Layer Manager
Configured = 
Layer Name = 
TopPasterLayer = 
BottomPasterLayer = 
TopSolderLayer = 
BottomSolderLayer = 
TopPasteMaskLayer = 
BottomPasteMaskLayer = 
TopSolderMaskLayer = 
BottomSolderMaskLayer = 
ComponentShapeLayer = 
LeadShapeLayer = 
ComponentMarkingLayer = 
Ratlines = 
Ratlines Color = 
Manage Colors = 
BoardOutline = 
Multi-Layer = 
Hole = Foro 
DRCError = 
Setting = Impostazione
Drawing area = Area di disegno
Export area = 
Transparency(%) = 
Copper Layer = 
Signal = 
Plane = 
Non-Signal = 
Other = 
Please delete all the objects of the layers first! The layers are: = 
You are converting Signal Layer to Plane Layer, There're some non-track objects remain on following layers. Please delete the objects manually on the canvas. = 
Please delete all the objects of this layer first! = 

#Dialog Fabrication Output
Create Files = Crea file
Check your {0}Gerber files{1} carefully before sending them to the factory = 
Download free Gerber Viewer (gerbv) = Scarica un visualizzatore Gerber gratis (gerbv)
Before generating the Gerber files = 
Please check the packages size and orientation carefully. = 
Please check for Design Rule Checking (DRC) errors in the Design Manager. = 
Please rebuild the copper area after modifying tracks and packages. = 
After generating the Gerber file, please use the {0}Gerber Viewer{1} to check whether it conforms to the design requirements. = 
Order at JLCPCB = 
Found the complicated polygon object can not be generated at Gerber, please remove or replace = 
ID: {id}, Object: {object}, Location: {location} = 

#Dialog DRC
Item = 
Value = Valore
value = 
Unit = Unità
Track Width = 
Track to Track = 
Track to Pad = 
Pad to Pad = 
Via to Via = 
Via Hole Size = 
Realtime DRC = 
{0} is too small! = 
Invalid DRC Rule = 
Rule = 
Via Diameter = 
Via Drill Diameter = 
Net List = 
Rule = 
Set Rule = 
Check Object to Copper Area = 
Show DRC Boundary while Routing = 
Check Object to Board Outline = 
Rule name already exists! = 
You should not delete default rule! = 
Rule list contains invalid rule setting! = 
Duplicate rule name exists! = 
via diameter is smaller than via drill diameter! = 
Currently rule name is not allowed to contain magical characters like . and $ = 
[drcRule]
All = 
[/drcRule]

#Dialog  Update PCB
Update PCB(Synchronizing PCB from schematics) = 


#Dialog Hotkey
Change Canvas Unit = 
Copy Selected Object(s) by Reference Point = 
Fullscreen = 
Undo the Previous Draw = 
Set Canvas Origin by Coordinate = 
Switch to the Next Signal Layer = 
Switch to the Previous Signal Layer = 
Switch object to top layer or bottom layer = 
Cycle Forward to the Next Open Tabbed Document = 
Cycle Backward to the Previous Open Tabbed Document = 
Switch to the Previous Layer(on the Numeric Keypad) = 
Switch to the Next Layer(on the Numeric Keypad) = 
Toggle Layers Which is Not Active = 
Hotkey Setting = Impostazione del tasto di scelta rapida
Document Type = 
Shortcut = 
Function = 
ALL = 
SCH = 
Rotate Selected Objects = 
Scroll or Move Selected Left = 
Scroll or Move Selected Right = 
Scroll or Move Selected Up = 
Scroll or Move Selected Down = 
Set canvas origin to the center grid of graphics in symbol; Set canvas origin to the center of pads in footprint. = 
Cross Document Paste = 
Explore & Find Components = 
Select All = Seleziona tutto
Cancel Current Drawing = 
Save = Salva
Drag Tool = Strumento di trascinamento
Draw Wire = Disegna cavo
Draw Bus = Disegna bus
Bus Entry = 
Junction = Giunzione
Net Flag GND = 
Net Flag = 
Draw Polyline = Disegna polilinea
Draw Polygon = Disegna poligono
Draw Bezier = Disegna curva di Bezier
Draw Arc = Disegna arco
Draw Rect = Disegna rettangolo
Draw Ellipse = Disegna ellisse
Freehand Draw = Disegno a mano libera
Freedraw = 
Draw Text = Disegna testo
Edit Selected Symbol = 
Draw Track = 
Draw Circle = Disegna cerchio
Cycle Select Object at Current Location = 
Draw Dimension = Disegna dimensione
Draw Connect = Disegna connessione
Draw CopperArea = Disegna area ramata
Change to TopLayer;<br/>Change Seleted Component's Layer to TopLayer; = 
Change to BottomLayer;<br/>Change Seleted Component's Layer to BottomLayer; = 
Change to Inner1 = 
Change to Inner2 = 
Change to Inner3 = 
Change to Inner4 = 
Highlight Net = 
Place Pad = 
Place Via = 
Measure = 
Change Routing Angle = 
Change Routing Conflict = 
Decrease Routing Width = 
Increase Routing Width = 
Decrease Snap Size = 
Increase Snap Size = 
Change Copper Zone Visible or Invisible = 
Rebuild All Copper Area = 
Toggle PCB Net Display = 
Show Attribute Dialog When Placing Object;<br/>Show Location Setting Dialog When Pasting Object(s) = 
Show Attribute Dialog When Placing Object;<br/>Show Absolute Offset Dialog When Selecting Object(s);<br/>Show Location Setting Dialog When Pasting Object(s) = 
Show Relative Offset Dialog When Selecting Object(s) = 
Open the FAQ Page = 
Move Object(s) by Reference Point = 
Choose Favorite Track Width While Routing = 
Copy Selected Object(s) and Paste Repeatedly = 

#My Projects Tree Menu
New Project = 
New Schematic = 
New PCB = 
New Spice Subckt = 
Modify = 
Delete = 
Add sub part = 
Clone = Clona
Version History = 
Refresh List = 
Create New Project = 
Delete = 
Attachment = 
Archive = 
Transfer = 

#Dialog Verify Package
Footprints Verification = 

#Dialog Edit Polygon Pad points
Edit Points = 
Center point is outside the pad = 
Hole should be inside the pad = 
Hole is draggable = 

#My Part Tree Menu
Clone = Clona
Reload parts = Ricarica componenti
Layers = Layer

#Dialog Preferences
Language = Lingua
Display Name = Mostra Nome 
HotKey Sync = 
My Theme Sync = 
Document Recovery Setting = 
Enable auto backup = 
Maximum backup level = 
Auto backup interval = 
minutes = 
Save to Server = 
Load from Server = 


#Dialog Schematic Library Wizard
Symbol Wizard = 
Style = 
Picture = Immagine
Pin Names = 
Contributor = 
contributor = 
owner = 

#Dialog Annotate
Annotate = 
Scope = 
Active Schematic only = 
All Opened Schematics = 
Method = 
Re-annotate all = 
Keep existing annotation = 
Direction = 
Rows = 
Cols = 
Reset = 

#Dialog Order
Order... = Ordina...
PCB Qty. = Qtà delle PCB
PCB Thickness = Spessore della PCB
PCB Dimension = Dimensione della PCB
Automatic calculation = Calcolo automatico
PCB Color = Colore della PCB
Green = Verde
White = Bianco
Blue = Blu
Red = Rosso
Yellow = Giallo
Black = Nero
Purple = Viola
Copper = Rame
Gold = Oro
Silver = Argento
Surface Finish = 
Hasl = 
Hasl(Lead Free) = 
ENIG = 
E-Test = 
Shipping Cost = Costo di spedizione
Cost Estimate = Costo stimato
Actual cost will be confirmed by email. = 
Shipping information = Informazioni di spedizione
Address = Indirizzo
ZIP/Post code = ZIP/Codice postale
City = Città
Country = Paese
Tel. = Tel.
After filling out the form above, we will email you with (i) the results of the Design Rule Checking (DRC), (ii) a quote and (iii) a payment link using Paypal. Shipping is normally one week from receipt of payment. = 



#Dialog Hot Key config
Restore All Default Shortcuts = 
Save Changes = 



#Dialog Polyline Maybe Wire
To connect electrical elements, please use Wire (W hotkey) and not Line (L hotkey). = .

Anonymous File = 
Anonymous File can not be cloned, but you can open it, then save it as a new file. = 
Free Documents = 
You must close the file before delete it! = 
Offline Project = 

#Message box
Confirmation = Conferma
Alert = 
Information = Informazione
information = informazione
Prompt = 
Error = Errore
error = errore
error! = errore!
Warning = Attenzione
Imported ok! = Importazione ok!
Some changes have not been saved. = Alcuni cambiamenti non sono stati salvati.
Your file hasn't been saved. Please save first! = 
Your file hasn't been saved. Are you sure you want to close it? = Il tuo file non è stato salvato. Sei sicuro di volerlo chiudere?
Error! Please try again later. = 
Are you sure you want to reload this page? = 
Are you sure you want to leave this page? = 
Confirm Reload = 
Confirm Close = 
Reload this page = 
Leave this page = 
Stay on this page = 
Don't reload = 
No connect flag only can be placed on Pin dot or the wire which is connected one Pin. = 
can not be placed on the wire which is placing No Connect Flag. = 
The footprint transfer to LCSC library class successfully = 
Device/Footprint goes into "SMT Device/Footprint Verified" list successfully = 

Load failure! = 
Load projects failed = 
error info = info sull'errore
error information = informazioni sull'errore
Guest can't create a new project. Please login! = L'utente ospite non può creare un nuovo progetto, esegui il login!
Please create a project before you do this! = Ti prego di creare un progetto prima di fare questo!
Add Part success = 
Click the new part and then edit it! = 
Delete my work = Cancella il mio lavoro
Delete my work. (Only deletes it from this list but not from the server) = 
Do you confirm this? = 
Successfully deleted! = 
Successfully Copied! = 
Cloning success! = 
Your title is too short! = 
Remove this part = 
Find and Jump to ... = 
Please type the prefix, such as U1, R1, C1 = 
Zoom as 1:1, you can print it and then create artwork for etching the PCB. = 
Exporting your works! = 
Guests can't import a file. Please login! = 
Please create a project before you import a file! = 
Import your LTspice file! = 
Open LTspice file = 
Please make sure the selected LTspice file is a file saved in LTspice V and above. = 
Saved successfully! = 
Save failed! = 
Can not place parts into this document. = 
User Package = 
System Package = 
File error = 
Please save your file first! = 
Email address is too short! = 
You have not selected a file to upload. = 
Update = 
Import.Import Changes = 
No changes, the PCB already matches the schematic! = 
Only public files can be shared = 
Conversion to PCB has failed! = 
Your username is too short! = 
Your password is too short, it must be more than 6 characters! = 
Conflicting shortcut = 
There is an empty PCB file. Please first run Convert Project To PCB... from the schematic = 
This file has been modified, are you sure you want to run this simulation before saving it first? = 
Please enter the Maximum Timestep! = 
Please enter the Stop Time! = 
All of these fields are needed. = 
Either your spice netlist is too big or the server is busy. Please try again later. = 
Your spice netlist is too big! Try breaking your circuit into smaller simulatable blocks. = 
Too many users in simulation. Please try again later! = 
Due to limited server resources, please wait 10 seconds for the interval in every time simulation. = 
Your circuit is too complex, we have not enough CPU resouce to support this simulation, please reduce your circuit as small as you can. = 
Simulation is queuing, try again after 30s. = 
Timeout = 
Demo accounts don't support simulation, please login first = 
Please login first = 
The schematic is showing errors, please check the simulation report carefully! = 
Simulation too long, maybe your schematic is too complex. = 
Non-simulated file = 
This file can only be opened in standard mode. To open it, please switch to standard mode. = 
Load your preferences success! = Caricamento delle preferenze avvenuto con successo!
Save your preferences success! = 
Update subckt ok! = 
Clone your file = 
Please type a new file name = 
Create file failure! = 
Schematics and PCBs can't be imported under My Libs folder, please choose a different folder = 
Libraries to be imported under My Libs folder = 
Please choose only the libraries needed = 
Maximum import is 200 libs at one time! = 
You libraries will be found under the My Libs folder = 
Add to Library = 
No items have been checked! = 
Nothing was found, please create it for yourself = Nulla è stato trovato, ti prego di creartelo da solo!
Search result = Risultati della ricerca
At least 3 characters needed = 
Add to my Favorite Parts = 
Added it OK. Please find it in your Favorite Parts = 
Please select its parent node = 
Libraries can not be exported as active project pdf. = 
Error:No GND = 
This circuit does not have GND. Please select GND from the circuit tool to add to the circuit. = 
Current circuit doesn't has Voltage Resource or Current Resource symbol, please place it first at left side EElib or Spice Library. = 
Probe can not connect with ground(GND)! = 
Spice symbols's attributes can't be empty. = 
Error:No Spice Symbol = 
Simulation limit = 
There is a multimeter in the circuit that needs to be simulated using the emulation command .tran or .op = 
An oscilloscope exists in the circuit and needs to be simulated using the simulation command .tran = 
There are components in this circuit that do not have a simulation model. Please use the base library component of the simulation mode for simulation. = 
Circuit does not have a probe = 
Make sure your pin numbers are even numbers = 
Duplicate Components Prefix = 
All components are hidden successfully! = 
All ratlines are hidden successfully! = 
Hidden the ratline of net {netName} successfully! = 
Duplicate Component Prefix = 
{0} exist = 
There are some invalid packages, are you sure? = 
Invalid Characters, library only allows [0-9a-zA-Z-_]
Annotation success = 
If you accept this annotation operation, please save your files. If not, close your files without saving. = 
This file can't be saved under libs project. Please choose other project or create a new project = 
Your file is unsaved. = Il tuo file non è salvato.
You can close the editor now. Have a good day! = Ora puoi chiudere l'editor e avere una buona giornata!
Successfully logged out = Uscita avvenuta con successo
You have at least one unsaved file open. Please save it or close it. = 
Please select a reference point = 
Please save your file before this operation = 
Please open a PCB document = 
Please save your file before '{0}'. = 
Please try again after saving this file. = Provaci di nuovo dopo aver salvato questo file.
This text can not be empty! = 
Export to Altium fail, please try again or contact us. = 
Connecting to server = Connessione al server
Please login before asking for help = Ti prego di effettuare il login prima di chiedere aiuto
This file has been modified, please save it first! = Il file è stato modificato, ti prego di salvarlo prima!
Remove this param = Rimuovi questo parametro
You cannot drag a part to the canvas, please click the part and move the cursor to the canvas and then right-click to place. = 
Undo/Redo temporary error = 
We are sorry but there is an unpredictable error in the undo/redo process. This problem will be fixed soon but in the meanwhile it is safe to continue working on your design. = 
The schematic has duplicate prefixes of the components, please make them unique. You can check them using the Design Manager. = 
Found duplicated prefix components, can not Import Changes, please modify the duplicated prefix or delete related component. = 
Please click the below help button to find out how to fix this problem. = 
Please create a board outline! Click the help button to find out how to create a board outline. = 
Can not fetch files from server, please check your network and try again = 
Please open a schematic first! = 
Can not find the schematic of this PCB = 
invalid points! = 
This file does not support this operation. = 
Net Name Conflict = 
Net name = 
{0} are in the same wire, please remove others and just keep one. = 
This field can't be removed! = 
Annular ring of the pad/via is too small = 
The size of the hole cannot exceed the size of the pad = 
Are you sure you want to create a multi-sheet designs? = 
Are you sure you want to create a {0}multi-sheet designs{1}? = 
Please build the copper area! Click the help button to find out how to build the copper area. = 
Suggest to set a package for this component first! = 
Please select an opened document first. = 
Some files failed to load. Please reload the page. = 

#UI Intro
Skip = 
« Back = 
Next » = 
Done = 
This is the user management menu. = 
This is the toolbar. = 
This is the navigation list. Under here you can find projects, files, parts and libraries. = 
Show or hide the toolbar to the top of the window here. = 
Show, resize or hide the left sidebar to the left of the window here. = 
Show or hide the right sidebar to the right of the window here. = 

#Standard libs
Passive Components = 
Power Supply = 
Diodes = 
Regulator = 
Transistor = 
Transformers = 
Gates = 
Vacuum Tubes = 
Switch = 
Relay = 
Capacitor(US) = 
Capacitor(EU) = 
Capacitor(EU)2 = 
Electrolytic Capacitor(US) = 
Electrolytic Capacitor(EU) = 
Electrolytic Capacitor(US)2 = 
Electrolytic Capacitor(EU)2 = 
Inductor(US) = 
Inductor(EU) = 
Potentiometer_US = 
Potentiometer_EU/IEC = 
Potentiometer_3D = 
Resistor(US) = 
Resistor(EU) = 
Resistor 45 Deg(US) = 
Resistor 45 Deg(EU) = 
Variable Capacitor(US) = 
Variable Capacitor(EU) = 
Variable Resistor(US) = 
Variable Resistor(EU) = 
Variable Inductor(US) = 
Variable Inductor(EU) = 
Varistor = 
Inductor2(US) = 
Inductor2(EU) = 
Battery = 
Voltage Source = 
Current Source = 
CCCS(Current Controlled Current Source) = 
CCCS2(Current Controlled Current Source) = 
VCCS(Voltage Controlled Current Source) = 
VCVS(Voltage Controlled Voltage Source) = 
CCVS(Current Controlled Voltage Source) = 
CCVS2(Current Controlled Voltage Source) = 

BV(Behavioral Voltage Sources) = 
BI(Behavioral Voltage Sources) = 
Epoly(Non-linear Voltage Source) = 
Gpoly(Non-linear Current Source) = 

Diode = 
LED = 
LED_3D = 
Schottky Diode = 
Varactor Diode = 
Zener = 
Unidirectional TVS Diode = 
Bidirectional TVS Diode = 
Diac = 
Bridge = 
78XX = 
79XX = 
LM317 = 
LM337 = 
TL431 = 
BJT(NPN) = 
BJT(PNP) = 
MOSFET(Nch) = 
MOSFET(Nch) Depletion Four-pins = 
MOSFET(Nch) Enhancement = 
MOSFET(Nch) Enhancement Four-pins = 
MOSFET(Pch) = 
MOSFET(Pch) Depletion Four-pins = 
MOSFET(Pch) Enhancement = 
MOSFET(Pch) Enhancement Four-pins = 
JFET(Nch) = 
JFET(Pch) = 
Darlington NPN = 
Darlington PNP = 
MESFET(Nch) = 
MESFET(Pch) = 

IGBT = 
SCR = 
Triac = 
Transform(US) = 
Transform(EU) = 
Transfrom(NEUTRAL-CTR TAP)(US) = 
Transfrom(NEUTRAL-CTR TAP)(EU) = 
Mutual Inductors = 
Mutual Inductors2 = 
Or Gate = 
Xor Gate = 
And Gate = 
Nor Gate = 
Nand Gate = 
Not Gate = 
Xnor Gate = 
Tube Diode = 
Tube Triode = 
Tube Tetrode = 
Tube Pentode = 
Voltage Controlled Switch = 
Current Controlled Switch = 
SPST ON = 
SPST OFF = 
Fuse = 
555 = 
555(Style2) = 
Speaker = 
XTAL = 
5pin Operational Amplifier = 
3pin Operational amplifier = 
Transmission Line = 
Voltmeter = 
Ammeter = 
LAMP = 
Opto Transistor = 

#Server Message
Need login = 
Bad password = 
We can't find your username or your email, please check it! = 
Make sure your uploaded file size is less than 3MB! = 
Bad file type = 
Empty file or bad file type, ensure your file is Eagle 6.0+ = 
This operation not supported on demo account = 
Can not share this file under a private project, please set the active project to public! = 
Login Failed Too many attempts. If you forgot your password, please {0}reset your password{1} or send an email to support@easyeda.com = 

#Dialog Common Buttons
Common Buttons Setting = 
Menu Setting... = 
Show/Hide = 
Move Up = 
Move Down = 
Reset All = 
Zoom = 
Place Pin = 

#System Setting Dialog
System = 
Zoom Mode = 
Scroll Key = 
CTRL + Scroll = 
Canvas Coordinate System = 
SVG Coordinate = 
Cartesian Coordinate = 
Open Wizard Dialog for New Schematic = 
Default Unit = 
Canvas Zoom Effect = 
Quality Priority = 
Speed Priority = 
Rotation Step = 
Add Teardrop Automatically = 
Assign Net for Free Track/Arc/Circle = 
Open Wizard Dialog for New PCB = 
Rebuild Plane Automatically = 
The Track's Routing Follows Component's Rotation = 
Display Pad's Number and Net = 
Favorite Track width = 
Track Width Setting = 


#Dialog Access Control
Permissions = Permessi
Operation = Operazione
Access Control = 
Project Access Control = 
Reject = 
Add User = Aggiungi utente
Bad email address = Indirizzo email non corretto
# backend return error info
Can't find this email address in EasyEDA. Your partner must be an EasyEDA user. = 

#Dialog waveForm
Grid Background = 
Pane Background = 
WaveForm Config = 
Export Waveform = 


#attr-canvas-grid-style
dot = 
line = 

#attr-canvas-frame-size
Other = 
A4 Portrait = 
A4 Landscape = 
A3 Portrait = 
A3 Landscape = 
A2 Portrait = 
A2 Landscape = 
A1 Portrait = 
A1 Landscape = 
Landscape = 
Portrait = 

#Stroke Style
solid = 
dashed = 
dotted = 

#Solid Region
Solid Region = 
Type = Tipo 
type = tipo 

#Dialog Libs Management
Report error = 
Please give us some information to help us find the problem. = 
Cannot place parts into this document: Schematic Symbols can only be placed into a Schematic; PCB Footprints can only be placed into a PCB. = 
Save it as a favorite part = 
Only logged-in users can save this component as a Favorite Part but guest (Anonymous) users can place this component into their design directly. Would you like to place this component now? = 

#Others
Find libs = Trova librerie
My Projects = Progetti Personali 
My Parts = Componenti Personali 
My Modules = Moduli Personali
Assembly LCSC Components = 
Modules = Moduli 
SCH Module = Modulo SCH
PCB Module = Modulo PCB 
System IC = 
LCSC (Official) = LCSC (Ufficiale)
LCSC Electronics = LCSC Elettronica 
Simple Mode = Modalità Semplice
Expand Mode = Modalità Estesa 
Help Verify = Verifica Help 
Favorite Parts = Componenti Favoriti 
Shared With Me = Condivisi Con Me 
Preview = Anteprima 
Preview Window = Finestra Anteprima 
System Default = Predefinito Sistema 
User Defined = Predefinito Utente 
Theme = Tema 
Theme Setting = Impostazioni Tema 
Close = Chiudi 
Open = Apri 
Collapse = Comprimi 
Toggle toolbar = Alterna toolbar
Toggle left bar = Alterna barra sinistra   
Toggle right bar = Alterna barra destra 
Reload = Ricarica
Mouse-X = Mouse-X 
Mouse-Y = Mouse-Y 
Mouse-DX = Mouse-DX 
Mouse-DY = Mouse-DY 
Bus entry x1 = Bus entry x1 
Bus entry x2 = Bus entry x2 
Bus entry y1 = Bus entry y1 
Bus entry y2 = Bus entry y2 
Yes = Sì 
No = No
OK = OK
Confirm = Accetta 
Continue = Continua 
Cancel = Annulla 
Update = Aggiorna 
Bus entry = Bus entry 
Filter = Filtro 
Check = Verifica 





Copy the contents of this box into a text editor, then save the file. Paste the edited text back into this box and click Apply to update the display. = Copia il seguente contenuto in un editor di testo e salvalo. Dopo averlo modificato, copialo nuovamente all'interno di questa casella di testo e premi Applica per aggiornare il display.  
Copy the contents of this box into a text editor, then save the file with a .svg extension. You can edit it in Inkscape or open it in your browser. = Copia il seguente contenuto in un editor di testo e salvalo con l'estensione .svg. Puoi modificarlo con Inkscape o aprirlo con il tuo browser.
Content is too big to show, you can download it directly. = Il contenuto è troppo grande per essere visualizzato, puoi scaricarlo direttamente. 
SVG format = Formato SVG 
SVG File = File SVG 
Description should be no more than 250 letters = La descrizione non deve superare i 250 caratteri 
The file save operation has timed out. Try again and check your Internet connection. = Il tempo per l'operazione di salvataggio é scaduto. Riprova e verifica la tua connessione internet. 
Export Netlist = Esporta Netlist 
Notifications = Notifiche 
Please select txt or json files. = Seleziona dei file txt or json. 
Failed to read file [{file}] = Impossibile leggere il file [{file}]
[{file}] is not a valid json file = [{file}] non è un file json valido
Invalid parameters! = Parametri invalidi! 
Download = Scarica 
Start = Avvia 
You have unsaved files, are you sure you want to log out without saving the files? = Ci sono dei file non salvati, sei sicuro di voler uscire senza salvarli? 
Please use the web version to run this function. = Questa funzione è disponibile solo nella versione web.  
Please save this file to you project! = Per favore salva questo file nel tuo progetto! 
Nothing changed = Nessuna modifica 
Delete Node = Elimina Nodo 
This layer is invisible. = Questo layer é invisibile. 
When the solid region is Board Cutout, please set the layer to Multi-Layer. = 
You should not try to assign a net to a Board Cutout solid region. = 
Net Length = Lunghezza Rete 
You can place a Pin in the schematic, but don't forget to group all of the Pins to a schematic component. Please click the help button to find out how to group them. If you just want to mark the wire, please use NetPort or NetLabel. = Puoi piazzare un Pin nello schemra, ma non dimenticarti di raggruppare tutti i Pins nello schemo del componente. Premi il bottone help per scoprire come raggrupparli. Se vuoi semplicemente marcare il filo, usa NetPort o NetLabel. 
Please input the modification = Inserisci la modifica 
The content must be between {0} and {1} characters = Il contenuto deve contenere tra i {0} e {1} caratteri 

Coming soon = Prossimamente 
No tool = Nessun tool 
Help us translate into your language = Aiutaci a tradurre nella tua lingua 
Pad = Pad 
Via/Hole = Via/Hole 
PCB Layers = Layers PCB 
Order PCB = Ordina PCB 
Share = Condividi 
Free = Gratuito 
Small = Piccolo 
Medium = Medio 
Big = Grande 


Embed = Embed 
HTML = HTML 
URL = URL 
BBCode = BBCode 
PNG = PNG 
Exporting as = Esporta come
Exporting as image = Esporta come immagine 
Exporting as {0}SVG{1} file. = Esporta come file {0}SVG{1} .
Exporting as pdf is recommended: pdf gives good quality printed output and a small file size. = E' raccomandato di esportarlo come PDF: produce una buona qualità di stampa e occupa poco spazio. 
Generate PCB Fabrication File(Gerber) = Genera File Fabbricazione PCB(Gerber) 
PenWidth-Increase = Incremento PenWidth 

#Generate Gerber
Generate Gerber = Genera Gerber
Gerber View = Visualizza Gerber 
Dimensions(Estimated) = Dimensioni(Stima) 
PCB Qty = Quantità PCB 
Copper Weight = Peso Rame 
PCB Price = Prezzo PCB 
Estimated Delivery Time = Stima Tempo di Consegna 

HASL(with lead) = HASL(con piombo)
LeadFree HASL-RoHS = Senza Piombo HASL-RoHS 
ENIG-RoHS = ENIG-RoHS 
Would you like to do Design Rule Checking (DRC) before generating the Gerber files? = Vuoi eseguire la Regola di Controllo di Design (DRC) prima di generare i file Gerber?
Yes, Check DRC = Sì, Esegui DRC 
No, Generate Gerber = No, Genera Gerber 
This PCB has uncompleted connection(s), do you want to check the connection(s)? = Questo PCB contiene una connessione/delle connessioni incomplete, vuoi controllare la connessione/le connessioni? 
Yes, Check Connection(s) = Sì, controlla connessione/i
It will then redirect to the web site of a thirdparty JLCPCB with which we cooperate. Are you ready? = Verrai reindirizzato su una pagina terza JLCPCB con cui collaboriamo. Sei pronto? 
Failed to submit your order, please contact us via support@easyeda.com for help. = Invio ordine fallito, per favore contattaci tramite support@easyeda.com per ulteriore aiuto.
Failed to submit your order, please contact us via QQ 800821856. = Invio ordine fallito, per favore contattaci tramite QQ 800821856.                                                                                                              
Order data generated finish, please click OK button and continue. = Dati dell'ordine generati, premi il bottone OK e continua. 
[generateGerber]
Layers = Layer
[/generateGerber]

[version]
Switch = Cambia 
[/version]


Export your file, then print it yourself. = Esporta il file, poi puoi stamparlo personalmente.
Trace width is too small = Larghezza traccia é troppo stretta 
Share = Condividi 

Images Attribute = Attributi Immagine 
Connect Pad to Pad = Connetti Pad a Pad 
Copper Area = Area di Rame 
Dimension = Dimensione 


Please check that you have used Wire and not Line to connect electrical elements. = Controlla di aver usato Filo e non Linea per connettere i componenti elettrici. 
PCB Fabrication Prices & capabilities = Prezzo & Capacità di produzione PCB 
Flip all texts on bottom layer = Specchia tutti i testi sul layer posteriore 
Create New Document = Crea Nuovo Documento 
General Package = 
General Packages = 
favorite Package = 
Board Cutout = 
Surface Mount = 
JLCPCB Part Class = 
base = 
expand = 
recommend = 
Basic Part = 
Extended Part = 
Recommended Part = 
smtWeld = 
thtWeld = 
manualWeld = 
furnaceWeld = 
Multi-Layer = 
Markdown Syntax = 
Markdown supported = 
Read only = 
Read/Write = 
More Libraries... = 
Decompress failed! = 
Load failed! = 
Loading = 
No Result = 

#Dialog Place Pin in schematic warning
Place Pin in schematic warning = 
You can place a Pin in schematic, but don't forget to group all of the Pins to a schematic component, please click the help button to find out how to group them. If you just want to mark the wire, please use NetPort or NetNabel. = 
I know. Do not show this again. = 

#Extensions Setting
Extensions Setting = 
Remove = 
Disable = 
Enable = 
(Disabled) = 
(Enabled) = 
Load Extension = 
Enable or disable will be applied after reload page = 
Your browser cannot run this function. = 
Your browser mode does not support indexedDB. Some features may not work properly. Are you using Private Browsing Mode? = 
Extension Files = 
Extension ID = 
Select Files = 

#Scripts
Script = 
Scripts = 
Script Content = 
Load from js file = 
UTF-8 encoded js file = 
Description = 
description = 
Not a *.js file = 
Failed to read file = 
System scripts cannot be modified = 
Create Subfolder = 
Create Script = 
Install Script = 
Install = 
Are you sure you want to remove this script? = 
Folder Name = 
Rename = 
Please select a script = 
Failed to load script = 
Run Script = 
Load Script = 
Title is required = 
Script content is required = 
System Scripts = 
User Scripts = 
You can right click on the tree nodes. = 

#PCB photoView toolbar
Top Side = 
Bottom Side = 
With Silk Layer = 
No Silk Layer = 
Photo View = 

#check update
Check Update = Verifica Aggiornamenti 
EasyEDA Editor {ver} is released. Would you like to switch to the new version now? = Una nuova versione di EasyEDA Editor {ver} é disponibile. Vuoi passare alla nuova versione ora? 
LCEDA Editor {ver} is released. Would you like to switch to the new version now? = Una nuova versione di LCEDA Editor {ver} é disponibile. Vuoi passare alla nuova versione ora?
Switch to New Version = Passa alla Nuova Versione 
Next Time = Non Ora 

#download project dialog
Generating download link... = Genera link per il download... 
Download project now = Scarica progetto ora 

#Import DXF
Import DXF = 
Apply Unit = 
Convert circle to HOLE on BoardOutLine layer = 
No shapes found = 
Fail to load the file = 
Please select a DXF file. = 
This feature only works for PCB document. = 
Select a DXF file = 

#Export DXF
Export DXF = 
Plated-Through-Hole Pads = 
Non-Plated-Through-Hole Pads = 
Silkscreen = 
Surface Pad = 

#Data Sync
Data Sync = 
Data Conflicts = 
Project or Document = 
Cloud-Side = 
Local-Side = 
Decision = 
Modified = 
Deleted = 
As Cloud = 
As Local = 
Skip = 
Data sync completed = 

#Team
Team = 
Teams = 
Switching team = 
Switch team failed = 
Load team info fail! = 
Load team info fail! Please reload. = 
My Teams = 
Create Team = 

#Dialog Footprint Manager
Footprint Manager = 
Open Footprint Manager = 
Schematic Components = 
Edit Pin Map Information = 
Package Categories = 
Components List = 
Personal = 
Component PIN information = 
Footprint PAD information = 
Footprint Categories = 
Pad Number = 
Search Footprint = 
Filter by keyword = 
System Libs = 

#dialog global delete
Drawings = 
Netlabel and netFlag = 
Texts = 
Wires = 
Board outlines = 
Footprints = 
Footprint = 
Tracks = 

#dialog board outline settings
Current Size =  
Paramenters = 
Start X: = Origine X: 
Start Y: = Origine Y: 
Round Rectangular = Rettangolo Arrotondato 
radius = Raggio 
only number is allowed! = 
please input valid value of width! = 
please input valid value of height! = 
please input valid value of radius! = 

#cross probe
The object you selected was not found in other documents. = 
No valid object for cross probe selected. = 
Can not probe. Refreshing the window may get it to work. = 
You need to login for this function to work. = 

#About Dialog
An Easier EDA Experience = 
Version = 
BuiltDate = 

#Auto Router Dialog
Auto Router Config = 
General Options = 
All Layers = 
Configure = 
Sorry, your web browser does not support this feature. Please run a modern browser. = 
Please make sure all objects with net are inside the board outline! = 
Cannot start again before previous activity is stopped = 
Please select a net = 
TrackWidth cannot be empty = 
Clearance cannot be empty = 
Router is time out. = 
Server is busy, please try again later. = 
Due to the limitation of {0}router server{1} resources, multiple routers executing concurrently are not supported, please try again later or do it manually :-) = 
Track Width is invalid = 
General Clearance is invalid = 
SMD Clearance is invalid = 
Diameter is invalid = 
Drill Diameter is invalid = 
Track width cannot be less than Design Rule Checking (DRC) setting value. = 
General Clearance cannot be less than Design Rule Checking (DRC) setting value. = 
SMD Clearance cannot be less than Design Rule Checking (DRC) setting value. = 
Hole size cannot be less than Design Rule Checking (DRC) setting value. = 
Design Rule's via diameter must larger than via drill diameter = 
Clearance cannot be less than Design Rule Checking (DRC) setting value. = 
Not a valid PCB, please check it again = 
Previous connection must be closed = 
Network error. Please try again. = 
Router error. = 
Invalid PCB. = 
General Clearance = 
SMD Clearance = 
#Ripup Nets
Skip Routed Nets = 
Remove Existing Tracks = 
Real-time Display = 
Router Layers = 
Via = 
Special = 
Special Nets = 
Skip Nets = 
Router Server = 
Local = 
Cloud = 
Available = 
Unavailable = 
Checking = 
Install Local Auto Router = 
Checking local auto router server... = 
Stop Router = 
Auto Router is running... = 

#Left Siderbar
EELib = 
Basic = 
Extend = 
Design Manager = 
Library = 
Spice Library = 
Shared = 
LCSC = 
LCSC Parts = 
Supply Flag = 
US = 
EU/IEC = 
US Style = 
Resistor = 
Capacitor = 
Inductor = 
Switch/Key = 
EU/IEC Style = 
CN = 
Connector = 
Switch/Relay = 
JLCPCB = 
Recycle Bin = 

# Protractor
Font Height = 
Precision = 
Protractor = 

#attr-pcbtext-line-width
Only default font family supports to change font width. = 
Font is missing! You can confirm the dialog and use default font instead or cancel the dialog then upload your font and do it again. = 

#Common
Owner = Proprietario
License = Licenza 
Part Pins = 
Net Pins = 
Net Ratlines = 
Add Parameter = Aggiungi Parametro
Histories record = 
Create Team = Crea Team 
Can't find this footprint on the server, please re-associate it. = 
The footprint name associated with the component and the footprint name on the server are inconsistent, please re-associate it. = 
The symbol pin number(s) of the component does not match the associated footprint pad number(s), please modify the symbol pin number(s) or re-associate the footprint = 
No footprint, please associate the footprint first. = 
Can't find the package = 
The path is for the project URL identify, it is unique (the identity of the project owned by the user cannot be the same) = 
It's with a letter or a number and can contain only numbers, letters, line-through, underscores, and points. It cannot be modified after saving. = 
Updating document to new format, please wait......After finishing please save your document with Ctrl + S. = 
Open at current project? = 
Please select a history to recover. = 
Be careful! When you click the "Recover" button, this sheet will be overwritten! = 
Recover = Recupera
There is no PCB under this project, would you like to create one? = 
Please make sure that the chose Altium Designer files are saved as ASCII files. = 
Export to Altium function is currently in beta: = 
1. Please be sure to read the notice before exporting: = 
Export Altium notice and disclaimer = 
2. Please be sure to check again after export! = 
I have read and agree = 
Export to Altium = 
Please make sure that the chose Eagle files are saved in Eagle v6.0 and above. = 
Please make sure that the Kicad files were compressed as the .zip file. = 
Open Altium Designer file = 
The more information please refer at : = 
Please use Gerber file instead of exporting Altium if you are going to do PCB manufacturing. All PCB factories support the Gerber file. Is it ok to Generate the Gerber file? = 
Yes, Generate Gerber = 
No, Export Altium = 
Open Eagle file = 
Open Kicad file = 
Select file(s) = 
Append to current project? = 
Append = 
Open as new project = 
Tip: Press {0}SPACE{1} or {2}R{3} to rotate the placing object or selected object. = 
Hotkeys Setting = 
I know. Don't show this again. = 
Manufacturer Part Number can not be less than 2 characters. = 
This prefix was changed to non-subpart format. = 
Save as New Project = 
Save to Existing Project = 
Sheet Setting = 
Sheet Size = 
Pre = 
pre = 
Invalid Data = 
Others = 
You are not authorized to share this project. = 
This project is private: if you continue sharing it will be made public. = 
Modify file info = 
Please input search keyword = 
Sort By = 
Date Created = 
Date Modified = 
Title = 
Ascending = 
Descending = 
Pin to Top = 
Unpin from Top = 
Expand All = 
Collapse All = 
Your file hasn't been saved, do you want to save it? = 
Don't Save = 
Library Owner: = 
verifyPkg.Value = 
State = 
Please select! = 
Route = 
Import successfully: = 
Import failed: = 
The title length must be between 2~128 characters. = 
Path only contain 'a-z、A-Z、- 、 _ 、0-9'! = 
Path must begin as 'a-z、A-Z、0-9'! = 
The path length must be between 4~128 characters! = 
The title length must be between 2~256 characters! = 
The title can not less than 3 charaters! = 
Do you want to delete this file? = 
Add sub part success = 
Please input name and prefix! = 
Board outlines are not closed = 
Import Altium file fail, the file needs to be an ASCII file encoded in UTF-8. = 
The Pins "{0}" are not snapped on the grid point! This part maybe will cause some errors in the schematic. = 
Check Pin = 
Failed to read {0} = 
{0} is invalid = 
{0} not found = 
Failed to execute script: = 
One or more js files not found = 
Only ONE {0} file is required = 
Extension ID is required = 
Extension ID is invalid = 
Extension ID is duplicated = 
No Result! = 
Load Error = 
loading = 
Failed to load spice data = 
Netlist = 
Tags = 
Pin Information: = 
Format incorrect, please check for the extra spaces or commas! = 
Round Radius = 
Keyword: = 
Image = Immagine
Image copied. = 
Copy failed. = 
Image Attribute = 
Locked = 
Unlock All = 
Unlock = 
Lock = 
Please input pin name and pin number! = 
Left-Hand Panel = 
Right-Hand Panel = 
Update All = 
The pin number(s) can't find the same pad number(s) = 
Designator = 
Replace = 
Update failed = 
Successfully updated = 
Update failed! = 
Successfully updated! = 
Successfully updated {0} component(s)! = 
Change = 
Check  Footprints = 
Network Error! = 
Find Similar Objects = 
Current Sheet = 
All Sheets = 
Kind = 
Range = 
Net Label/Net Flag/Net Port/Voltage Probe = 
Bezier/Freehand Draw = 
Arc/Pie = 
Objects Attributes = 
Any = 
Same = 
Different = 
Circular = Cerchio 
Expose Copper = 
"{0}" font is missing. Please add the font to the font family list. = 
Place Component = 
Delete Segment = 
Angle = 
Board Thickness = 
Layer Distance = 
Silk Screen = 
Surface Finish Color = 
Colors = 
Board Color = 
Board Side = 
Silk Screen = 
Silk Screen Color = 
Display = 

# # Array and Clone
Distribute Array = 
Array Type = 
Matrix Array = 
Circular Array = 
Item Rotation = 
Location = 
Items per Column = 
Items per Row = 
# Column Spacing
# Row Spacing
Spacing(Degrees) = 
Start Degree = 
Rotate Item to Match = 
Clockwise = 
Anti-Clockwise = 
Distribute by = 
Column = 
Row = 
Array Clone = 
Number of Rows = 
Number of Columns = 
Number of Copies = 
Distribute Range(Degrees) = 

## Theme color dialog
BusEntry = 
Foreground = 
Common Used = 
Original Theme = 
Theme Setting = 
Change the theme colors of your design = 
White on Black = 
Black on White = 
Custom Theme = 
Color Setting = 
Apply Setting = 
Theme Setting... = 
Bus Entry = 
Foreground = 
Symbol Graphics = 
Common Used = 
Draw = 
Sheet = 
The original theme only works for placing the new symbols. = 
Selection Highlight = 
Net Label / Port = 

My Theme = 
My Theme Settings = 
Apply 'Custom Theme' On = 
Creating New Schematic = 
Opening Existed Schematic = 
Please fill in all parameters! = 
Convert to Board Cutout = 
Prefix Position = 
Name Position = 
Center = 
Top = 
Bottom = 
Left = 
Right = 
Does not support multiple objects to convert to Board Cutout at the same time = 
Does not support multiple objects to convert to pad at the same time = 
Convert to Board Cutout = 
Convert to Pad = 
Convert to Component Shape = 
Combine to Continuous Track = 
Convert to Solid Region = 
Substrate = 
3D View = 
2D View = 
Pin Color = 
Name Color = 
Number Color = 
Dot = 

[theme]
Sheet = 
[/theme]


#history dialog
[history-dlg]
Number = Numero
Editor = 
[/history-dlg]
View File History = 
Save Time = 

Invalid Format = 

#Dialog Teardrop
Round Pad / Via = 
Rectangle / Oval / Polygon Pad = 
Applying Teardrops = 
Removing Teardrops = 
Waiting = 
Progressing... = 

No schematic in the project! = 

Move Forward = 
Move Backward = 

#Dialog Panelize
V-CUT = 
Stamp Hole = 
No Panelize = 
Border and Marking = 
Create Border = 
Border Height = 
Border Position = 
Create Positioning Holes = 
Create Fiducial Marks = 
Top and Bottom = 
Left and Right = 
Stamp Hole Group - Column = 
Stamp Hole Group - Row = 
The number of rows and columns cannot be set to 1 simultaneously = 

#edit path point
[editPathPoints-dlg]
Arc(R) = 
Type = Tipo
Action = 
add before = 
add after = 
delete = 
[/editPathPoints-dlg]

#edit polygon point
[editPolygonPoints-dlg]
Action = 
add before = 
add after = 
delete = 
[/editPolygonPoints-dlg]
You have unconfirmed edit! = 
Invalid edit! = 

#Dialog PCB Information
PCB Information... = Informazioni PCB...
Signal Layers = Strati Segnale
None Signal Layers = Strati Senza Segnale 
Pads = Pads  
Surface Pads = Pads Superficiali
Plated Through-hole Pads = Pads placcati a foro passante
None Plated Through-hole Pads = Pads non placcati a foro passante
Holes = Fori
Vias = Vias
Length of Tracks = Lunghezza delle Piste
Copper Areas = Aree con Rame

#Differential Pair Routing
Differential Pair Routing = 
Differential Pair Rule Setting = 
Please input track width = 
Please input clearance = 
Routing Rules = 

#Route Length Tuning
Track Length Tuning... = 
Tracks with different net or non-track found in current targets. = 
Please select the signal tracks to be tuning. = 
The total length exceeds the Design Rule Checking (DRC) constraint, continue ? = 
45° Angle = 
90° Angle = 
DRC Track Length : = 
Current Length : = 
Additional Length : = 
Target Length: = 
Current Length: = 

can not connect to the server = 

#Dialog Copper Area Manager
Copper Area Manager... = 
Copper Area Manager = 
Order = 
Name = Nome
Layer = 
Color = Colore
Net = 
Move Up = 
Move Down = 
Apply = Applica
Cancel = 
Copper Area do not allow self-intersection! = 
No copper area! = 
#Dialog report error
Datasheet = 
Verification = 
Symbol = 
Pad Number = 
Pad Size = 
Remark = 
Correct = 
Incorrect = 
Submit = 
Tip = 
Please select one component = 
Location X = 
Location Y = 
Your current browser version may not support some features. Please use the latest version of Chrome or Firefox, or try the desktop client. = 
EasyEDA Client = 
LCEDA Client = 
Chrome = 
FireFox = 
New Version = 
Switch Version = 
Member = 
Update Time = 
Editor = 
Current Version: = 
Select a version to switch = 
3D Model = 
Board Side = 
Display = 
Copper = Rame
Create New Version = 
Create new version success! = 
Version Management = 
Switch success! = 
Please close current version's documents first! = 
Creator = 
Create Time = 
Fail to connect to server! Please check your internet connection status and try again! = 
Spice Number = 
Create = 
3D Outline = 
Cannot create the slot hole via the board outline, please use the following methods: = 
Use the solid region and set its type as Board Cutout = 
Select a Track/Arc, right-click to use the "Convert to Board Cutout" = 
Select all the closed Tracks/Arcs, right-click to use the "Convert to Board Cutout" = 
The more information please refer at = 
Save "{0}" success! = 
Save "{0}" failed! = 
Invalid Size = 
Processing = 
Invalid Size = 
NetFlag GND = 
NetFlag VCC = 
NetFlag +5v = 
No Useful Data! = 
SVG Preview = 
Prefix contains not supported charater(s) ! = 
Name contains not supported charater(s) ! = 
Create Grid Path = 
Please Input Name = 
Building Copper Area = 
Processing = 
Opening File = 
Update from Library = 
Update Footprint = 
Find footprint(s) have been updated, do you want to update? = 
3D File: = 
Model List = 
Are you sure merge net {0} and net {1}? = 
Display Footprint = 
Display Footprint Name While Placing Component = 
Annotate Prefix Automatically After Placing Component = 
Program Error, Please Contact Technical Support! = 
Search Engine = 
Keyword to Filter = 
Normal Mode = 
Expand Mode = 
3D Model Manager = 
3D Model Preview = 
3D Model = 
3DModel = 
Document = Documento

[pcblayer]
3DModel = 
Document = Documento
[/pcblayer]

Adjustment = 
View Larger Image = 
Previous = 
Previous Image = 
Next Image = 
Notice: For reference only, please refer to the real product = 
It's under designing, please wait. = 
The width of track/arc/circle can not less than 0.1mil! = 
clone success ! = 
Footprint Naming Reference = 
3D Model Manager = Gestisci Modello 3D
Will jump to the Lichuang open source hardware platform (OSHWHub.com) to improve the information and share. Whether to continue? = 
Will jump to the EasyEDA open source hardware platform (OSHWLab.com) to improve the information and share. Whether to continue? = 
The project content page will open. After adding a description and setting the project to public, you can click the share button to get the share link. = 
This project is not public, can not view homepage! = 

[grid]
None = 
[/grid]

#lib verify and mounted
This component is verified = 
This component is unmounted = 

#find component
Find Next = Trova Successivo
Object not found = Componente non trovato 

##offset Elements
Offset X = 
Offset Y = 
Offset = 
Absolute Offset = 
Relative Offset = 
Absolute Offset... = 
Relative Offset... = 
Reference Point X = 
Reference Point Y = 

# Inner Plane layer
Rebuild Plane = 
PlaneZone Properties = 
Change to a plane layer is not allowed during track routing. = 
#pcblib rect
Fill = 
Fill Type = 
[PlaneZone]
Solid = 
[/PlaneZone]

Solid Region do not allow self-intersection! = 

The prefix or name or text too far away from the footprint, if you don't want it to show up please make it hidden. = 
The prefixes are not allowed to repeat! = 
Save failed! The origin of the canvas is not in the graphics! Whether to set the origin automatically? = 
The origin of the canvas has been set in the graphics now, you can save again. = 
Backup Project = 
Open Project Directory = 

{0} items updated = 

The current file {0} has an updated version. Do you want to overwrite it? If you want to open the latest version, please close the current file and reopen it. = 
Yes, Overwrite It = 
No, Keep It = 

Download Client = 

Search tutorial、open source projects etc. = 

Go to LCSC and search for = 
Go to LCSC = 

Hide Ratline Layer and Keep the Component Prefix When Paste Objects = 

ALL.layer = 
Copper.layer = 
Non-Copper.layer = 
Other.layer = 

Please enter at least 2 characters! = 
View Datasheet = 
View Datasheet... = 

The corresponding package or network could not be found in the currently open PCB document = 
delete fail = 

[crashRecovery]
Libraries = 
[/crashRecovery]
Canvas origin anomaly! = 

Component's Name = 
Component's Prefix = 
Component's Footprint = 

[findlib]
Clear = Cancella
Apply Filters = 
Result = 
Place = Posiziona
Prev = 
Next = 
Total {count} Count = 
About = About
Items = 
[/findlib]

Object = 
Layers and Objects = 
All = 

Add custom = 

Connections = 
Attempted: = 
Completed: = 
Failed: = 
Total Vias: = 

Please confirm moving option = 
Only this pad = 
For this component = 
View Owner = 
View Detail = 


# place batch vias
Place Vias = 
Placing Vias = 
Removing Vias = 
Batch Vias for Copper = 
Add/Remove Vias = 
Diameter = Diametro
Drill Diameter = 
Column Spacing = 
Row Spacing = 
Multiple vias have been placed, do you want to rebuild the copper area? = 
Remove vias finish, do you want to rebuild the copper area? = 
The width of track/arc/circle can not less than 0.051mm/2mil/0.002inch! = 
Save fail! Please try again! = 
Please select a copper outline = 
Can't find copper area at other layers, please add the copper area with the same net at other layer first. = 

Add favorite success! = 
Remove favorite success! = 
Remove favorite failed! = 
Whether if remove favorite? = 
Split by ';' for multi tags = 

This size is the determined size! = 
The associated pad has been locked = 
Split by space or , for multi tags = 

Rotation X = Rotazione X
Rotation Y = Rotazione Y 
Rotation Z = Rotazione Z

Some fields are filled invalid data = 
start time should be earlier than stop time = 
Number of points should be less than 100 in octave variation = 
Start frequency should be less than stop frequency. The suffix meg stands for Mega,m stands for milli = 
Get historical records fail! = 
This 3D model didn't create the outlines successfully, please import it again or contact with us. = 
There is No Tag! = 
Assign successful! = 
Found footprint's pad number doesn't match the schematic component's pin number, please correct the pad number and try again! = 
Update Attribute = 
Please fill in at least 5 words. = 
Mouse hovering over the track to highlight the entire network = 
Net Highlighting While Cursor Hover the Track = 
When circle set as "Yes", the Pin length must more than 6 = 
Hi, I found a problem of your library, this library seems incorrect.\ntitle:{title}\nType:{type}\nlink:{link}\n{content}\nThank you! = 

Logout fail! Please try again! = 
Logout success! We look forward you to use LCEDA again! = 
Logout success! We look forward you to use EasyEDA again! = 
Click to Preview 3D = 
[logoutDialog]
Logout = Esci
[/logoutDialog]

[findlibTag]
All = 
[/findlibTag]

Export Pick and Place File = Esporta File Pick and Place 
Mirror the bottom component's X coordinate (JLCPCB doesn't need) = 
Work Space = 
Include panelized components' coordinates = 
Personal Workspace = 
Work Space - {name} = 
Work Space - Personal = 
Cloning = 

Project Owner = 
Clone Project = 
Homepage = 
Apply for Education Edition = 
Load Organization failed = 
Joined = 
Favorite = 
This operation will unfavorite this project, do you want to continue? = 
View Homepage = 
Private Project = 
3-7 days = 
Close Tab = 
Close Other Tabs = 
Close All Tabs = 
Open in New Window = 
Cursor Snap to Component's Origin or Pad Center While Dragging Component = 
Undefined = 
Input = 
Model Unit = 
File Unit = 
This part contains subparts, please make sure you have checked other subparts before reporting error, do you want to continue? = 

[saveAs]
Power = 
[/saveAs]

Assign LCSC Part# = 
Unexpected error while converting. Perhaps unsupported file type or program bug. = 
Found duplicated component IDs, please click "OK" to re-assign component ID automatically, and then save the document and try again. = 

#electromagneticSimulation
Electromagnetic Simulation... = 
You will upload Gerebr to SuperEM for electromagnetic simulation (only upload Gerber, not including account data), do you want to continue? = 
SuperEM is a 3-D full-wave electromagnetic simulation and design platform for high-speed PCB circuits and antennas, which is developed by Faraday Dynamics, Ltd. = 
Visit the SuperEM = 
SuperEM User Guide = 
Upload Gerber to SuperEM successfully, please click "OK" buttun to continue = 

Format = Disponi 
View = Visualizza
Design = Disegno
Simulation = Simulazione
Advanced = Avanzate
Fabrication = Fabbricazione
Check DRC = Controllo DRC
Simulation Setting = Impostazioni della Simulazione
BOM = BOM 
PCB Fabrication File(Gerber) = File di Fabbricazione PCB(Gerber) 
Pick and Place File = File Pick and Place 
Parts Order = Ordina Componenti
PCB Order = Ordina PCB 
SIM = 
STD = 
WaveForm = 

Place Module = 
Please enter identification letters: = 
Only support English letters, up to 5. = 

Exist doesn't annotate prefix component(s) in the module, please edit and annotate the unique prefix(s) for component(s) first. = 
Opening = 

Also update track's net (Only applies to circumstance under which prefix/netlabel changes and no component/wire is added or removed) = 

# desktop client error feedback
Cannot open online documents on Project Offline mode. = 

Please select a project = 
Opened Projects = 
Open Project = Apri progetto
Close Project = 
Open All Projects = 
Close All Projects = 

Doesn't support JLCPCB SMT Service = 
for JLCPCB SMT Service = 

Reset failed! There are duplicate component prefixes in the current schematic: = 
Reset failed! There are duplicate component prefixes in the current PCB: = 
Please modify the component prefixes first to ensure that the component prefix is unique. = 

LCEDA(Standard) - A Simple and Powerful Electronic Circuit Design Tool = 
EasyEDA(Standard) - A Simple and Powerful Electronic Circuit Design Tool = 

#Dialog for Package Custom Data
Please input the data title = 
Data title duplicated = 
Cannot be more than {0} characters! = 
Only latin alphabets, digits, underscore(_) and hyphen(-) are allowed. = 
Invalid value of item {0} = 
Update DFM = 
Custom DFM Data = 
Saved custom data successfully! = 
Save custom data failed! = 
Will replace the graphics and custom data of current document, after imported please adjust the 3D model. Continue or not? = 
Open footprint "Custom Data" dialog = 

# Create lead shape
Create Lead Shape = 
Base on Pad Center = 
Base on Canvas Origin = 
Lead shape = 
Footprint Type = 
From pad shape = 
Lead length = 
Lead width = 
Lead diameter = 
Scaling ratio = 
Leads creating direction = 
Auto = 
Horizontal = 
Vertical = 
Canvas origin to lead edge = 
Canvas origin to body edge = 
Lead soldering length = 
Lead soldering part diameter = 
Component shape object doesn't overlap lead shape object, please check carefully. = 
The solder mask expansion of pads ({0},{1}) has a small clearance(less then 0.08mm), it will cause the soldering too short, please modify. = 
The paste mask expansion or custom paste mask layer objects of pads ({0},{1}) has a small clearance(less then 0.15mm), it will cause the stencil to create fail, please modify. = 
System footprint must exist pad number 1 or A1, please modify the pad number. = 
System footprint doesn't allow two or more pad numbers are 1 or A1, please modify the pad number. = 
Document layer has circle object, but jlcPara's polarity is 0, please check the Custom Data. = 
There are exist repeat pad numbers: {padNumber}, please check, if it is correct please ignore this. = 
Can't find the circle at the component marking layer, or this circle doesn't at the same quadrant with the 1st pad, please check whether it is correct. = 

ROUND = 
RECTANGLE = 
OCTAGONAL = 
Upper left = 
Lower left = 
Center of Pads = 
First Pin = 
Package Name = 
Pins Number = 
Rows Of Pin = 
Columns Of Pin = 
Polarity = 
Pad Shape = 
Body Diameter = 
Lead Span = 
Lead Vertical Span = 
Body Length = 
Body Height = 
Pin Diameter = 
Pin Length = 
Pin Height = 
Pin Solid Width = 
Pin Solid Height = 
Pin Spacing = 
Pin Horizontal Spacing = 
Pin Vertical Spacing = 
ThermalPad = 
Pad Expansion = 
Custom PasteMask = 
Fabrication Tolerance = 
Plcarment Tolerance = 
FirstPin Position = 
Package Origin = 
Expansion Size = 
Corner = 
Angle = 
Fillet = 
Chamfer = 
Update Preview = 
Number of pins (left and right) = 
Number of pins (up and down) = 
Reference Use Cases = 
Package Type = 
Capacitance = 
Resistance = 
Bidirectional Diode = 
Inductance = 
Crystal Oscillator = 
Diode = 
LED = 
Fuse = 
Entity height = 
Lead Overhang = 
Lead Thickness = 
Unknown mistake = 
Has ThermalVias = 
Polar Capacitance = 

Create Component Marking = 
Create component marking successfully! = 
No elements on component shape layer! = 
No elements on lead shape layer! = 
No pad of number 1 or A1, please modify the pad number. = 
Save failed! Component marking circle is at the axis. Do you want to recreate the component marking? = 
If autoroute fail, you can export the autoroute file(DSN) to third-party autorouter tool(Such as: Konekt Electra, Eremex TopoR etc.), and export the session file(SES) after finished autoroute, and then import to PCB. = 
Auto route failed! Found abnormal pad(s) data, please modify the pad width and height: = 
Select Properties = 
Combine the same parts' prefixes in one row = 
Please check at least one item! = 
Pins = 

